┌──────────────────┐
│..................│
│..................│
│..................│
└──────────────────┘
